+++++++++++++++++++++
+     +    +       +
+ +++ + +++++ ++++++
+ +   + +   + +    +
+ + +++ + + + + ++ +
+ + +   + + +   +  +
+ + + +++ +++++++  +
+ + +     +     +  +
+ +++++++ + +++ +  +
+         +   S+  +
+++++++++++++++++++++
