+++++++++++++++++++++
++S            +    +
++++++++++++   +    +
+              + +  +
+  ++  ++++    + +  +
+  ++     +    +    +
+  ++     +    +   E+
+  ++  +++++++++    +
+  ++     ++   +    +
+  +                +
+++++++++++++++++++++